{
  "rows": [
    "11111111111111111111",
    "18100010001000100101",
    "10101010101010110101",
    "10101000101010000101",
    "10001011111011110101",
    "11111010000010000101",
    "10000000111110111101",
    "11111111100010000001",
    "10000000001011111011",
    "10111101101000000001",
    "10001001001101111101",
    "11101011111000100001",
    "10111010001111111111",
    "10000000101000100001",
    "11101110100010101001",
    "10001011111111101101",
    "10111000100000101001",
    "10101010101110101011",
    "10000010001000001091",
    "11111111111111111111"
  ]
}